WE ./texture/cool/wall_4.xpm
NO ./texture/cool/wall_2.xpm
EA ./texture/cool/wall_1.xpm
SO ./texture/cool/eagle.xpm
DO ./texture/cool/wood.xpm

F 7,8,6
C 43,127,254

1111111111111111111111
10E000000000000000100001
11111111112111011111011
1000000000000000011111
111101112110000000000
10000000000
111000000000
	100000000
1111111111111111



