WE ./texture/cool/wall_4.xpm
NO ./texture/cool/eagle.xpm
EA ./texture/cool/pepsi-max-britvic.xpm
SO ./texture/cool/eagle.xpm
DO ./texture/cool/wood.xpm

F 7,8,6
C 43,127,254

11111111111111111111111111111111111111111111111111111111111111111111111111111111111111111111111111111111111111111
1E0000000000000000000000000000000000000000000000000000000000000000000000000000000000000000000000000000000000000000000000000000000000000000000000000000000000000000000000000000000000000000000000000000000000000000000000000000000000000000000000000000000001
111111111111111111111111111111111111111111