WE ./texture/blank/lightest_grey.xpm
NO ./texture/blank/dark_grey.xpm
EA ./texture/blank/grey.xpm
SO ./texture/blank/light_grey.xpm
DO ./texture/blank/black.xpm


F 30,30,30
C 255,200,200


111111
10010100
10101
1111111111111111111111111111111
    	1000000000110000000000001
1011000001110000000000001
100100000000000W000000001
111111111011222221110000000000001
100000000011000001112111111111111
1111011111 110111000010001
111101111 111011101010010001
11000000110101011100000010001
1000000000000000000000000001
1000000000000000110101010001
11000001110101011111011110111
1