WE ./texture/cool/wall_4.xpm
NO ./texture/cool/wall_2.xpm
EA ./texture/cool/wall_1.xpm
SO ./texture/cool/eagle.xpm
DO ./texture/cool/wood.xpm

F 7,8,6
C 43,127,254

1111111111111111111111111111111111111111111111111111111111111111111
1E00111111111101211210000000000000000001100000000200200001000000111
1110100000000001000010111111121211111111100111111111111111111111111
1110111111011111110112111111111000000000112000000000000000111111111
1110200000011111000000111111111121211121100111110111111111111111111
1112111111111111111011100200200000000001100111110110000111111111111
1110000000000001111211111111111111111121112111110101112111111111111
1111112121212121111000000200020000000000010110020000000011111111111
1111110101011101111101111111111111111121212110111111111111111111111
1111100101011000000001111111111111100001010100000000000000000000001
1111101101011111112111111111111111111101010100000000000000000000001
1111000101000000000000200111111111111101010100000000000000000000001
1111111111111111111111111111111111111100000100000000000000000000001
1111111111111111111111111111111111111111111111111111111111111111111

