NO              ./path_to_the_north_texture
SO ./path_to_the_south_texture
EA ./path_to_the_east_texture
WE ./path_to_the_west_texture





F 220,100,0
C            225,30,0





111111
10010100
10101
1111111111111111111111111111111
    	1000000000110000000000001
1011000001110000000000001
1001000000000000000000001
111111111011000001110000000000001
100000000011000001110111111111111
1111011111 11011100000010001
111101111 111011101010010001
11000000110101011100000010001
10000000000000000000000000001
10000000000000001101010010001
11000001110101011111011110N111
1111111 111 111 111111 1111111
111111 11 111111 111  11   11



111












