WE ./texture/cool/oak_plank.xpm
NO ./texture/cool/diamond.xpm
EA ./texture/cool/oak.xpm
SO ./texture/cool/blueice.xpm
DO ./texture/cool/obi.xpm

F 7,8,6
C 43,127,254

11111
100000000000000010010000001000000000001000000000000000000
100000000000000010010000001000000000001000000000000000000
100000000000000010010000001000000000001000000000000000000
100000000000000010010000001000000000001000000000000000000
100000000000000010010000001000000000001000000000000000000
100000000000000010010001110000000000001000000000000000000
100000000000000010012110000000000000001000000000000000000
100000000000000112100000000000000000001000000000000000000
111111111111112000000000000000000000001000000000000000000
100000000000020000000000000000000000002000000000000000000
10000000000001111112111111111111111112111111112111111
10000000000001000010200000001111111100011111110200001
10000000000001000010100000001110000200020000110100001
10000000000001000010100000001111111100011111110100001
10000000000001000010200000001110000200020000110100001
10000000000001000010100000001111111100011111110100001
10000000000001000010100000001110000200020000110100001
10000000000001000020200000001111111100011111110100001
10000000000001111112111111111111111112111111112111111
10000000000000000000000020000000000000000000000000002
10000000000000000000000010000000000000000000000000001
11111000000000000000000011000000000000000000000000001
10000111211000000000000011010000000000000000000011110
10000000001000000000000011010000000000000000011200000
10000000010000000000000011010000000000000000010000000
10000000010000000000000011010000000000000000010000000
10000000100000000000000011010000000000000000010000000
10000000100000000000000011010000000000000000010000000
10000001000000000000000011010000000000000000010000000
10000001000000000000000011000000000000000000010000000
11111111111111111111111111111111111111111111111111111111